a|ai-we|a-we | (one)	  	
//
P

pack | korr | korr
package | korrid | korrid
painful | oddigiri | iddikain
palace | ka dool | diffi
palma christi | ubkogne | ukkogne
palm tree / doam / stem  | betti / umbo / ombo | fenti / umbi / oomboo | (dates / doam / stem of palm tree)
paltry | firsa | birsa
panting | a houddi, amohotti | a houddin
pear tree | gou'bb | gou"bb
part, peice | fersa | motge'o
partial to | darie, ge'aig | okatain, geegin
past time | way | shoab
pasture | NA | eew
paste | dorkid | dorkid
pastry | tobid | toffid, orbid
pat | tubtif, tuftir | taffa, tir
patch | NA | degdeg
paved, seat | sourou, dukko | togo
pay | ouskour | ouskir
pea | orre | orre
pebble | ada | ada
peel | fungne fungne | fogod
peg | koge'ir | koge'ir finde
penis | gleet, koffe | kou'ffi
perhaps | hebet | hebet
perplex | koun ou | sokkaolla feen
persistant | goll - bou | utta menge'in
pick | ub, hub | uff
pick up | det | det
pierce | ibir, shag | shag
pigeon | mine | NA
pillar | ail, erundi | ou'ssou
pimple | soush'shad, dorm | doush'shad
pinch | soulouk | sounggout
pinck | bertpad | bortoad
pint | obar | obar
pipe | kodoash dowwa | kodoash, dowwa
pipe clay | kofrokki | kogorokki
pipkin | soule | deede
piss | ekked | ge'orron
pissed | ekkedsou | ge'orron
pit | digur, buttur | koull - buttur
place | aagur | aggur
plant nursery / transplant / tree | tukkiti / tuk / kokkitti | tukkitti / tuk / kokkitti
planting | taire | nangir
plait | nit | nit
plait hair | moge | nit, moge
plaster | kuss | kuss
play / play games | kushk / kushk | batur / soan
player | kushkur | soanutti
plea | arrid, erri | irrid
pliable | shooroo | ngne'aruw
pluck, mow | bish | bish
plug | godd, gott | gott
plunder | NA | kosor
plunge | tubir | tuffir
pod | kush-she | kush-she
pollen | air | air
pollening / will be pollen | airur /bi airtuki | airur / fa airtukin
poverty | NA | galaba
possess | kowi, koali | kounin
pot | dadi | dadi
pound  | touk | touk
pour / pour in | boag / boagoun |foag / foagou
pouring | boagur | foageed
precede | nog | geer
pregnant | mew | ge'ounti
present / present | atta / a'gi | ekkir / a'gin | ( command / is here)
press / press in | ou'rr / kou'd | ou'rr / kou'd
pretty | singir - toad | mustoad
prevent | meer | meer
prevention | merrur | meereed
pride | irrig'ed | ko'bekki
pring, bring | utta | ekkir
proud | newerti dool | kobe
prostrate | ege'ek | ege'ek
provision | aween | fasil
prune | sam | sab
puber | witriss | nisurk
puddle | obog | obog
pull | NA | hurrib
pulsate | mou'kki | mou'kkin, wokkin
pupil | heeran | heeran
pure | sooda | sooda
purslane | gebrik - lagne | kalange
push | ge'ung, kul | dugne - ge'nng
puss / eye puss | witge'i / missi kul | winti /issangne
put | ouskor | ouskir
put forth leaves | NA | fodin
put in | oundour | oudir
put on | NA | okkir
put out | oas | oas
quad | kara | kara
quaf | goutge | koatge
quail | tennana, furri | four - four'rtgei
quake | gogne'ur, goyur | gougneed
quakes | gogne'i goy'i | gougne'in
quarrel | kursig'e | dingi, gelid
quarrels | a kursigi |a dingin
quarrel some | kursig utti | dingutti
quarrel together | NA | dinging
quarter | kemisore | kemissi
quern | ge'ou | ge'aw
quick | shoutta | shouttia
quid | shekm | shekm
quiet / be quiet | kood bou / kood | kood a feen / kood
quietly | kitta | welaisin
quoth | we-waber | oag
rabbit | didlug | dou'ngne
rag | blungne'i | fekke
rain | han essi arroo | umbor, unborom
raise | sok- kosgegir | sok ka kairkir
ram | eg'ed-n-ondi | eg'ed-n-ondi
rather | mun in deg | mun - ne- kin
rattle | sholow | shalow
raw | dessi | dessi
razor | gugne'ir | gugne'ir
reach | door | do'ow
reached | doorsou | do'owon
real, true | ale | ale
realty | ale toad | ale toad
reap | ge'oar | goar
reaps | ge'oari | goarin
reaping time | ge'oarur | goarur
reconcile / with | gendgir / gend | g'engkir / g'eng
recovered | way-yoasoo | wey'yoason
red | gaile | gail
redeem | osark, baiw | baiw
reed | age | age
refusal | moanur | moanti
refused | moansou | moanon
refuse to give | NA | ikkir
realtive | egitti, titge | tair
release | karakel | karakir
remember | ge'il | ge'il
remainrest | kewiddi | keedo
remove aside | soa | ingri
repair | NA | tomor
reptile | nolli | nolli
resist | gober | tour gne'turbuk
rest at noon | no'ow | no'ow
riddle | orti, norti | orti-n- ortinan
ride | egir | doag
riding / to make ride | egirbou / egirgir | doag a feen / doagkir
right |iyn | iyon
ring / ear ring | temeem /tubla, akush | temeem / bertawi
rinse / rinse | elew /shougon, ousou | elew / shougm | (dishes / mouth)
riot | sar | sar
ripe | kurge bou | kurge a feen
rippen | kurge'gir | kurge'ir
orad | ge'ir | duwi, ge'ourra
roar | arri | boang
rob | mag | murk
robber | maguss | murkutti
rock, stone | koulou | kid
roll | gergige | g'erg'ed
roof | nooki | dumbi
root / root | oost / geeo | mame / geoo | ( tree / origin)
rope | iri | ulli
ropes | irri | ulli
rope maker | eeri | milli
rove / to make rove | tisk / tishgir | tish / tish kir
rover | tish bou | tish a feen
row / is rowing | waw / a wawi | waw / a wawin
rub dirts | koad | koad
rub with dust | NA | shsish'w
rumour | basgir | baskir
run | boad | boad
run away | douss | douss
running / to make liquid run| boad bou / wedgir | mira feen / terew a feen
rupture, rip | nod | moushg
saddle / under saddle | degir / waga | deg'er / toafil
sound / sound | shurkel / shurkel -gir | firr a feen / firrikir | (well / make well)



*****
| S |
*****


safflower seed | kooshe | kooshe
sago | goll, gollou | hungou
said | wesoo | eegon
sake | ge'oro | sibahir
sale | geanter | ge'anti
saliva | ge'ombod | g'oumoud
salt | oumboud | imeed
same | ter-ter | tullin
sand | seew | seew
sand stone | NA | soame
saturday | sumte | sunte
saw / saw | nulsou / sair | nulon /saor | ( saw dust / to cut wood)
say / to say | we'i / we'tir | eegin / eeg atir
says / is saying | we'i / a we'i | eegin / a-g-eegin
scab | kuy'yo | kuy'yo
scatter | NA | meheg
scent | noummel | oungi
scissor | kisoreen | kisoreen
scorpion | eige'een | saged
scrape / scrape out | soad / fork | soad / fork
scratch | koart | koart
scour | ge'egid | ge'ogod
scum | alogne'-ney | ushishi
search in dust | kurb | kurb
seashore | abtogoag | abol-in
second | owwetti | ewwotti
seduce / has seduced | el / el, elsoo | elt / elted -on
seducing | elur | elti
see / is seeing | nul /a nuli | nul
 /a nuli
seed / seed |taire / tairi | koge,ir / wair | (object / action)
seed stpme | safa, bus | kounutte fasa
seing | nulti, nulur | nulti
select | bur | fur
selection | buur | fureed
self | kidir | uy
self love | kidir dolli | ay dolli
sell | ge'anoas | ge'anoas
seller | ge'anoasil | ge'anoasi
send / send back | ishin, idir / weedgir | eedir / weedkir
sender | ishinil, gobir | eediro
sending | ishinur | eedirti
seven | koled | kolod
seventeen | demin kolod | dime koloda
seventeenth | demin koleditti | dime koloditti
seventh | koleditti | koloditti
sew | nige | nitge
sewing | nige'ur | nigte'eed
shade | nooni, urri | noor
shadoof | kiye | kiye
shadow | odil | ollin-noor
shake / shake off dust | shond / tib, tob | shong, shon / tiff
shallow | koutti, fettal | fitge'i
sharp | nuddi | nurri
sharpen | ungissi | angissir
shave | gungne | gungne
shear | kerb | kerb
sheer | kerbi | kerbi
sheep / sheep herd | ourtitge'i / kou'de | ourtigiri / koude
sheild | karoo | goungnea
shoe, sandle | koriss, korsi | dir
short | ourtouna | ourad
shoulder | oa,osmur | osmur
show | amintir | amuntikir
shrink | kodom | kodom
shrunked hand | kourro | kourra
shroud | tougou'r | tougou"r
shut / shut up | kob / god | koff / got
sible | nerre mougil | kogosh mougi
sickle | torab | tirib
silence | kit, kitto | wiyyo-houss
similar | kotti | kelli
sing | aa, oa | kair
singer | aai, oai | kaire kaire shar
singing | oarur, oal | kaire
single | koatoad | koatoad
sink | kidgir | kidir
sip | shilib | sheeb, koatge
sister | essi | essi
sit | taig, agidd | teeg, aag
six | gorige | gorge'o
sixteen | demin de | deme gorge'o
sixth | gorge'itti | gorge'itti
skim | wullkir | ot
skin | age'in | nawa
skull | goumour | goumour
slabber | ge'iddi | ge'iddi
slaughter | geog'ur | goge'eed
slave | nougoud | oshshi
salavary | nougoud kid | oshikki
slay | goge | goge
sleep | nair | nair
sleeping / to make sleep / will sleep | nairbou / nairkid / bi nairi | nair e feen / nairkir / fa nairin
sleepy | nelige bou | nall a feen
sling | tolloulaya | togoge
slip | sirge | sirge
slipper | sirge'ur | sirge'ure
slowly | noare | eebeetge
slut | tullad | tullad
smash | toagige | felfel
small | kinna | koudood
smell / smell | iris / sounn | gutti / sounn | (aroma / the act)
smelling | sounnur | sounneed
smile | NA | bishik
smoke / is smoking / is smoking | goussooti / a goussi / gousso outigi ani | toulli / a toullin / toulli-ga-aneen | (smoke / on fire / smoking tobacco)
snake | a'ya | wisslungi, bislungi
snap | tomm | toom
sneeze | adiyi, arigne | urngne
snore | atehtehe | atounnin
snub nose | sorin fut ge bou | sorong butge aad
soak | nengne 'ir | neyyir
soft | ge'ondo | ge'ondo
soft mud | hogne' olokke | hogne'ol okke
solid | kogor | kogor
some | bagid | bagid
son / grand son | uffi, toad / ussi | ga'toad / ussi
son in law | otti | otti
song | oarur | kaire
soul, spirit | newerti | shogorti
sour | ourour | sutti
south | ongo | oro
speak | buy, bunge | bunge
speaks | bui, bungnei | bungne
spear | sha | sharti
special | korin | abour koari
speech | buyneed | bugneed
speed | boadir | war a weed
spider | korab | kourabe
spin | nod, wedd | kusir
spindle | wede | wede
spinging | a weddi a noddi | a kusain
spit | boge'ok | ge'isik
spite / spite | koutig / koutigur | koutir / koutireed | (the action / the root)
spleen | nednudi | nur-n-ondi
spill | NA | fok
split | wuitge boo | guk a feen
spoilt | NA | forre
spoke | buysoo, bungne, sou | bugne'on
spoon | kash eddi | kash-eddi
sprain | bood bou | bood a feen
sprawl | obige, tourb | fush a fiy
spray | soor | soor
spread | uwid | uwwir
spring water |borbor | bourbou'r
sprinkle | soull | soull
spy | ge'ab | ge'ab
spying | ge'abi | ge'abi
squander | NA | meheg
squanderer | NA | mehegad
squat | den | kunder
squatting | den gi ge'om | kunder kaoushir
stagnate | taibboo | ge'ab - mangen
stand | kout | kout | (stop walking)
stand up | kout taib | kouta menege
stain | geirib | ge'irb
star | wissi | win'ge'i
starvation | orgid | orgid
stay | aag | aag
staying | aagi | aagin
stench | siy'yel | koush-shad
step | bat | fung'a
stick | witge'ir | gulle
still | elekkon | elgon
stir | kash | kash
stone | koulou | kid, koulod
stone engrave | kouloogi koad | soam
stook | tortor | tortor
stop | taib | men'ge
storm | kuge-wur | kinngneud
story | koumma | koumma
stradle | bagash | bugsh
straight / stand straight| ogoad / ogoad imbel | ogoad / ogoada men'ge
strangle | gid | gir
straw | silti | seetti | (chopped straw)
strength | ibirti | ibirti
strike | null | null
strong | ibirti koal | ibirti ko
submerge | wa;awgor | wa;aw or
success | ogige'ked | ogge' ikki
suffering | wittag'a | wuttag'e
suffocate | gomgomir | goummikir simmikir
summer | bogon bagon | gaon
sun | musil | masha
sunday | kirag'e | kirag'e
sunrise | musil belti | masha-n-fulti
sunset | musil-toare | masha-n-toarti
support | NA | tamul
swagger / swagger | bellige / bellaige'a |bellige / bellaige'a | (the act / the person)
swallow | goll | goll
swallow powder | kib tringne | kiff
sway | terigne | trin'gne
sweat | tullutti | simutti
sweep | kull | kull, koss
sweep dust | toy | toy
sweet | ingiri | age'ow
swell | ney bou | ney'ya a feen | (tumor)
swim | bow | koutge
swimming | bowur | koutge'e
swing | soll | sull
sword | siwid | farugne
 

***********
| T: 101 |
***********
tail | aiw | ge'lew
tail-less | wagtail | mourrouge
tailor | kade nige'il | kitti nitge'i
take | inge | enn
talisman | soar | sho
talk | we'tir | eeg atir
temarish | noare | moor
taste | enni, engetel | enni
taseful | enni koal | enni ko
tasteless | bussuri | fussi
tattoing | touk, shok | ut
tatto | toukur, shokur | utterki
teach | kourkid | koulli kir
teacher | fegeer | fegeer
tear / tear | messi-nessi / orr | magne-essi / orr | ( from crying / to rip )
tearing | orrur | orrad | (ripping apart)
teeth | neletge'i | needtoo
tell tale | koumma koummi | koumma kommi
temple / temple | birbe / tibil | birbe / tibil | (place of warship / NA)
ten | dimin | dime
tent | kerri | kerri
tenth | demin-itti | dim-itti
termite | nore | nore
test | gaw | gaw
testicle | sord, gorbagne | gormagne
thanks | aturwi | aturwin
thankful | turwur | turwur
that | mun | mun
thatch | silte | silutte
their | tenna | tenna
there | mundo | mundo
therefore | waidir | waididdo
these | ingoo | ingoo
they | tir | ter
thick | do'ro | koulou'm
thicken | nair | nerr
thicket | koshe | toushshi
thigh | doge'in bok | dogogne
thin | ese | o'low
thing / for nothing | urti / kitta | ourti / houssun
third | toskitti | touskitti
thirst / to cause thirst | erid / eridgir | ge'okkin / ge'okkir
thirteen | demin de toski | dime tousko
this | in | in
thorn | kinissi | ginde
those | mungoo | mungoo
thought | ge'illsou | ge'illon
thousand | do're | do're
thrash | noar | noor
thrasher | noarur | noorur
thread | ool | tissi
thread bead | or'ou | ge'ood, ow
three | toski | tousko
throat | goas | goas
throw | kud, louffe | kud 
throw backward | urk | urk
throw off | NA | weerk
thunder | kuge fogor | doo'doo
thus | kewiddern | adingra
tick | wissi | wissi
tickle | kelkie | kill - killi
tie | digir | degir
tied | digirsou | degiron
tying tightly | moar | moar
till | mokko | famin
tire | muris | kigne
tired | muris bou | kigne'a feen
to | abid, ked | teer
toast | nib | tokk
toddle | dori | do'ow
tomb | ie | te
tongue | ned | nur
torrefy | usil | usil
torrfied | usle | usle
tortoise | hofing- efna | amunduki
tour | dage | greed | (go around)
touring | dagebou | greeda feen
trace | tig | tig
train animals | moag, morgir | moag | (animal trainer)
trap | begid | bigid
trash | dettid | dettad
travail | tatge- eed | tatge-eed
tread | futge | butge, ge'ukk
tree | ge'ow'wi | gunde
tremble / is trembling | kerker /a ker-keri | kerker / a ker-kerin
trencher | toalug | toalug
tribe | aab | aab
trill | killil | ge'uw
trite | balagne | fekke
tritrate | ge'oag, futge | burs
trod | NA | burs
true | alete | aleya
tubersoe | NA | kes
turban | kusir | kasir
turbanise | kass | kass
turbid | kirig, sherig | kirg, tirg
turning over | ewr | ou'gir
turtle dove | kou'roo | doge
tweezers | buskull | buskull
twelve | dimen ow'w | dime-r- ow-ow
twenty | are, ari | aro
twig | utge bou | age'a feen
twiged | utge oasou | age'oason
twin | bursi, baras | bursi
twinkle | tawinge | twinge, timinge
twist of thread | iri, eer | mill ge'oude
two | owwi | ow-wa
udder | gaiw | gaiw
ugle | dogir | dogor
ugle face | koidogir | kogne dogor
unable | maros, maso | moskon
uncle / uncle | un bana / ungy | aboa-n-enga / ungy | (father's brother / mother's brother)
unique | toad | toad
unskilful | doash | doash
up and down | dogoag togoag | doro tuwwo
upland | ab | toddi
uplift | kouge'gir | kairkir
urine | ekked | erre
utrine | NA | uwwi | (blood realtive)


pg: 108 - V


























in stead | ten-agur | agur-tunna








