pack | korr | korr
package | korrid | korrid
painful | oddigiri | iddikain
palace | ka dool | diffi
palma christi | ubkogne | ukkogne
palm tree / doam / stem  | betti / umbo / ombo | fenti / umbi / oomboo | (dates / doam / stem of palm tree)
paltry | firsa | birsa
panting | a houddi, amohotti | a houddin
pear tree | gou'bb | gou"bb
part, peice | fersa | motge'o
partial to | darie, ge'aig | okatain, geegin
past time | way | shoab
pasture | NA | eew
paste | dorkid | dorkid
pastry | tobid | toffid, orbid
pat | tubtif, tuftir | taffa, tir
patch | NA | degdeg
paved, seat | sourou, dukko | togo
pay | ouskour | ouskir
pea | orre | orre
pebble | ada | ada
peel | fungne fungne | fogod
peg | koge'ir | koge'ir finde
penis | gleet, koffe | kou'ffi
perhaps | hebet | hebet
perplex | koun ou | sokkaolla feen
persistant | goll - bou | utta menge'in
pick | ub, hub | uff
pick up | det | det
pierce | ibir, shag | shag
pigeon | mine | NA
pillar | ail, erundi | ou'ssou
pimple | soush'shad, dorm | doush'shad
pinch | soulouk | sounggout
pinck | bertpad | bortoad
pint | obar | obar
pipe | kodoash dowwa | kodoash, dowwa
pipe clay | kofrokki | kogorokki
pipkin | soule | deede
piss | ekked | ge'orron
pissed | ekkedsou | ge'orron
pit | digur, buttur | koull - buttur
place | aagur | aggur
plant nursery / transplant / tree | tukkiti / tuk / kokkitti | tukkitti / tuk / kokkitti
planting | taire | nangir
plait | nit | nit
plait hair | moge | nit, moge
plaster | kuss | kuss
play / play games | kushk / kushk | batur / soan
player | kushkur | soanutti
plea | arrid, erri | irrid
pliable | shooroo | ngne'aruw
pluck, mow | bish | bish
plug | godd, gott | gott
plunder | NA | kosor
plunge | tubir | tuffir
pod | kush-she | kush-she
pollen | air | air
pollening / will be pollen | airur /bi airtuki | airur / fa airtukin
poverty | NA | galaba
possess | kowi, koali | kounin
pot | dadi | dadi
pound  | touk | touk
pour / pour in | boag / boagoun |foag / foagou
pouring | boagur | foageed
precede | nog | geer
pregnant | mew | ge'ounti
present / present | atta / a'gi | ekkir / a'gin | ( command / is here)
press / press in | ou'rr / kou'd | ou'rr / kou'd
pretty | singir - toad | mustoad
prevent | meer | meer
prevention | merrur | meereed
pride | irrig'ed | ko'bekki
pring, bring | utta | ekkir
proud | newerti dool | kobe
prostrate | ege'ek | ege'ek
provision | aween | fasil
prune | sam | sab
puber | witriss | nisurk
puddle | obog | obog
pull | NA | hurrib
pulsate | mou'kki | mou'kkin, wokkin
pupil | heeran | heeran
pure | sooda | sooda
purslane | gebrik - lagne | kalange
push | ge'ung, kul | dugne - ge'nng
puss / eye puss | witge'i / missi kul | winti /issangne
put | ouskor | ouskir
put forth leaves | NA | fodin
put in | oundour | oudir
put on | NA | okkir
put out | oas | oas
quad | kara | kara
quaf | goutge | koatge
quail | tennana, furri | four - four'rtgei
quake | gogne'ur, goyur | gougneed
quakes | gogne'i goy'i | gougne'in
quarrel | kursig'e | dingi, gelid
quarrels | a kursigi |a dingin
quarrel some | kursig utti | dingutti
quarrel together | NA | dinging
quarter | kemisore | kemissi
quern | ge'ou | ge'aw
quick | shoutta | shouttia
quid | shekm | shekm
quiet / be quiet | kood bou / kood | kood a feen / kood
quietly | kitta | welaisin
quoth | we-waber | oag
rabbit | didlug | dou'ngne
rag | blungne'i | fekke
rain | han essi arroo | umbor, unborom
raise | sok- kosgegir | sok ka kairkir
ram | eg'ed-n-ondi | eg'ed-n-ondi
rather | mun in deg | mun - ne- kin
rattle | sholow | shalow
raw | dessi | dessi
razor | gugne'ir | gugne'ir
reach | door | do'ow
reached | doorsou | do'owon
real, true | ale | ale
realty | ale toad | ale toad
reap | ge'oar | goar
reaps | ge'oari | goarin
reaping time | ge'oarur | goarur
reconcile / with | gendgir / gend | g'engkir / g'eng
recovered | way-yoasoo | wey'yoason
red | gaile | gail
redeem | osark, baiw | baiw
reed | age | age
refusal | moanur | moanti
refused | moansou | moanon
refuse to give | NA | ikkir
realtive | egitti, titge | tair
release | karakel | karakir
remember | ge'il | ge'il
remainrest | kewiddi | keedo
remove aside | soa | ingri
repair | NA | tomor
reptile | nolli | nolli
resist | gober | tour gne'turbuk
rest at noon | no'ow | no'ow
riddle | orti, norti | orti-n- ortinan
ride | egir | doag
riding / to make ride | egirbou / egirgir | doag a feen / doagkir
right |iyn | iyon
ring / ear ring | temeem /tubla, akush | temeem / bertawi
rinse / rinse | elew /shougon, ousou | elew / shougm | (dishes / mouth)
riot | sar | sar
ripe | kurge bou | kurge a feen
rippen | kurge'gir | kurge'ir
orad | ge'ir | duwi, ge'ourra
roar | arri | boang
rob | mag | murk
robber | maguss | murkutti
rock, stone | koulou | kid
roll | gergige | g'erg'ed
roof | nooki | dumbi
root / root | oost / geeo | mame / geoo | ( tree / origin)
rope | iri | ulli
ropes | irri | ulli
rope maker | eeri | milli
rove / to make rove | tisk / tishgir | tish / tish kir
rover | tish bou | tish a feen
row / is rowing | waw / a wawi | waw / a wawin
rub dirts | koad | koad
rub with dust | NA | shsish'w
rumour | basgir | baskir
run | boad | boad
run away | douss | douss
running / to make liquid run| boad bou / wedgir | mira feen / terew a feen
rupture, rip | nod | moushg

**** S : PG 89 *****




















